index,0,1,2,3,4,5,6,7,8,9,10,11
0,2,0,0,2,0,0,1,1,0,0,0,0
1,0,1,0,0,1,0,0,0,1,1,0,0
2,0,0,1,0,0,2,0,0,0,0,1,1
3,2,0,0,2,0,0,1,1,0,0,0,0
4,0,1,0,0,2,0,0,0,1,1,0,0
5,0,0,2,0,0,2,0,0,0,0,1,1
6,0,1,0,0,1,0,0,0,2,1,0,0
7,0,0,1,0,0,1,0,0,0,0,2,1
8,1,0,0,1,0,0,2,1,0,0,0,0
9,0,0,1,0,0,1,0,0,0,0,1,2
10,1,0,0,1,0,0,1,2,0,0,0,0
11,0,1,0,0,1,0,0,0,1,2,0,0
